T;T;N;N;L;N;N;N;N;T
T;T;T;N;N;T;N;N;N;T
T;T;N;N;T;T;T;N;N;T
T;T;N;N;N;T;T;N;N;T
T;T;N;N;N;T;T;N;N;T
T;T;N;N;N;T;T;N;N;T
T;T;N;N;T;T;B;N;N;T
T;T;N;B;T;T;N;N;N;T
T;T;N;N;N;B;T;N;T;T
T;T;N;N;N;N;N;N;T;T